AircraftModel	dataModel.Aeronautics
Aircraft	dataModel.Aeronautics
Airline	dataModel.Aeronautics
Airport	dataModel.Aeronautics
FlightNotification	dataModel.Aeronautics
Flight	dataModel.Aeronautics
AgriApp	dataModel.Agrifood
AgriCrop	dataModel.Agrifood
AgriFarm	dataModel.Agrifood
AgriGreenhouse	dataModel.Agrifood
AgriParcelOperation	dataModel.Agrifood
AgriParcelRecord	dataModel.Agrifood
AgriParcel	dataModel.Agrifood
AgriPest	dataModel.Agrifood
AgriProductType	dataModel.Agrifood
AgriSoil	dataModel.Agrifood
Animal	dataModel.Agrifood
Compartment	dataModel.Agrifood
Pen	dataModel.Agrifood
BreedingOperation	dataModel.Aquaculture
FishContainment	dataModel.Aquaculture
BatteryStatus	dataModel.Battery
Battery	dataModel.Battery
StorageBatteryDevice	dataModel.Battery
StorageBatteryMeasurement	dataModel.Battery
BuildingOperation	dataModel.Building
Building	dataModel.Building
VibrationsObserved	dataModel.Building
VaccinationCertificate	dataModel.COVID19
AgentDCAT-AP	dataModel.DCAT-AP
CatalogueDCAT-AP	dataModel.DCAT-AP
Dataset	dataModel.DCAT-AP
DistributionDCAT-AP	dataModel.DCAT-AP
Camera	dataModel.Device
DeviceModel	dataModel.Device
Device	dataModel.Device
PrivacyObject	dataModel.Device
SmartMeteringObservation	dataModel.Device
ACMeasurement	dataModel.Energy
InverterDevice	dataModel.Energy
TechnicalCabinetDevice	dataModel.Energy
ThreePhaseAcMeasurement	dataModel.Energy
AeroAllergenObserved	dataModel.Environment
AirQualityObserved	dataModel.Environment
ElectroMagneticObserved	dataModel.Environment
FloodMonitoring	dataModel.Environment
IndoorEnvironmentObserved	dataModel.Environment
NoiseLevelObserved	dataModel.Environment
PhreaticObserved	dataModel.Environment
RainFallRadarObservation	dataModel.Environment
WaterObserved	dataModel.Environment
FireForestStatus	dataModel.Forestry
GreenEnergyGenerator	dataModel.GreenEnergy
GreenEnergyMeasurement	dataModel.GreenEnergy
PhotovoltaicDevice	dataModel.GreenEnergy
PhotovoltaicMeasurement	dataModel.GreenEnergy
Open311_ServiceRequest	dataModel.IssueTracking
Open311_ServiceType	dataModel.IssueTracking
keyPerformanceIndicator	dataModel.KeyPerformanceIndicator
MediaEvent	dataModel.Multimedia
MotionDeviceSystem	dataModel.OPCUA
CrossSection	dataModel.OpenChannelManagement
OpenChannel	dataModel.OpenChannelManagement
OffStreetParking	dataModel.Parking
OnStreetParking	dataModel.Parking
ParkingAccess	dataModel.Parking
ParkingGroup	dataModel.Parking
ParkingSpot	dataModel.Parking
FlowerBed	dataModel.ParksAndGardens
Garden	dataModel.ParksAndGardens
GreenspaceRecord	dataModel.ParksAndGardens
SmartPointOfInteraction	dataModel.PointOfInteraction
SmartSpot	dataModel.PointOfInteraction
Beach	dataModel.PointOfInterest
Museum	dataModel.PointOfInterest
PointOfInterest	dataModel.PointOfInterest
Store	dataModel.PointOfInterest
BoatAuthorized	dataModel.Ports
BoatPlacesAvailable	dataModel.Ports
BoatPlacesPricing	dataModel.Ports
SeaportFacilities	dataModel.Ports
QueueMonitor	dataModel.QueueManagement
Asset	dataModel.RiskManagement
CyberAnalysis	dataModel.RiskManagement
Exposure	dataModel.RiskManagement
GISData	dataModel.RiskManagement
Hazard	dataModel.RiskManagement
Measure	dataModel.RiskManagement
Mitigation	dataModel.RiskManagement
NetworkServiceAlert	dataModel.RiskManagement
Risk	dataModel.RiskManagement
Vulnerability	dataModel.RiskManagement
Pallet	dataModel.RoboticIndustrialActivities
Piece	dataModel.RoboticIndustrialActivities
RobotArm	dataModel.RoboticIndustrialActivities
RoboticCell	dataModel.RoboticIndustrialActivities
VacuumPump	dataModel.RoboticIndustrialActivities
EOAnalysis	dataModel.SatelliteImagery
EODataHub	dataModel.SatelliteImagery
EOGeoDataLayer	dataModel.SatelliteImagery
EOInstrument	dataModel.SatelliteImagery
EOProduct	dataModel.SatelliteImagery
EOSatellitePlatform	dataModel.SatelliteImagery
SMAnalysis	dataModel.SocialMedia
SMCollection	dataModel.SocialMedia
SMPost	dataModel.SocialMedia
SMRefLocation	dataModel.SocialMedia
SMUser	dataModel.SocialMedia
StreetlightControlCabinet	dataModel.Streetlighting
StreetlightGroup	dataModel.Streetlighting
StreetlightModel	dataModel.Streetlighting
Streetlight	dataModel.Streetlighting
Event	dataModel.TourismDestinations
TouristDestination	dataModel.TourismDestinations
TouristTrip	dataModel.TourismDestinations
BikeHireDockingStation	dataModel.Transportation
BikeLane	dataModel.Transportation
CityWork	dataModel.Transportation
CrowdFlowObserved	dataModel.Transportation
EVChargingStation	dataModel.Transportation
ItemFlowObserved	dataModel.Transportation
RestrictedTrafficArea	dataModel.Transportation
RestrictionException	dataModel.Transportation
RoadAccident	dataModel.Transportation
RoadSegment	dataModel.Transportation
Road	dataModel.Transportation
SpecialRestriction	dataModel.Transportation
TrafficFlowObserved	dataModel.Transportation
TransportStation	dataModel.Transportation
VehicleModel	dataModel.Transportation
Vehicle	dataModel.Transportation
ArrivalEstimation	dataModel.UrbanMobility
GtfsAccessPoint	dataModel.UrbanMobility
GtfsAgency	dataModel.UrbanMobility
GtfsCalendarDateRule	dataModel.UrbanMobility
GtfsCalendarRule	dataModel.UrbanMobility
GtfsFrequency	dataModel.UrbanMobility
GtfsRoute	dataModel.UrbanMobility
GtfsService	dataModel.UrbanMobility
GtfsShape	dataModel.UrbanMobility
GtfsStation	dataModel.UrbanMobility
GtfsStopTime	dataModel.UrbanMobility
GtfsStop	dataModel.UrbanMobility
GtfsTransferRule	dataModel.UrbanMobility
GtfsTrip	dataModel.UrbanMobility
PublicTransportRoute	dataModel.UrbanMobility
PublicTransportStop	dataModel.UrbanMobility
Activity	dataModel.User
UserContext	dataModel.User
WasteContainerIsle	dataModel.WasteManagement
WasteContainerModel	dataModel.WasteManagement
WasteContainer	dataModel.WasteManagement
Blower	dataModel.WasteWater
OffGasStack	dataModel.WasteWater
WasteWaterJunction	dataModel.WasteWater
WasteWaterTank	dataModel.WasteWater
WaterConsumptionObserved	dataModel.WaterConsumption
Curve	dataModel.WaterDistributionManagementEPANET
Junction	dataModel.WaterDistributionManagementEPANET
Network	dataModel.WaterDistributionManagementEPANET
Pattern	dataModel.WaterDistributionManagementEPANET
Pipe	dataModel.WaterDistributionManagementEPANET
Pump	dataModel.WaterDistributionManagementEPANET
Reservoir	dataModel.WaterDistributionManagementEPANET
SimulationResult	dataModel.WaterDistributionManagementEPANET
SimulationScenario	dataModel.WaterDistributionManagementEPANET
Tank	dataModel.WaterDistributionManagementEPANET
Valve	dataModel.WaterDistributionManagementEPANET
WaterQualityObserved	dataModel.WaterQuality
SeaConditions	dataModel.Weather
WeatherAlert	dataModel.Weather
WeatherForecast	dataModel.Weather
WeatherObserved	dataModel.Weather
AccessPoint	dataModel.WifiNetwork
WifiPointOfInterest	dataModel.WifiNetwork