AircraftModel	dataModel.Aeronautics
Aircraft	dataModel.Aeronautics
Airline	dataModel.Aeronautics
Airport	dataModel.Aeronautics
FlightNotification	dataModel.Aeronautics
Flight	dataModel.Aeronautics
AgriApp	dataModel.Agrifood
AgriCrop	dataModel.Agrifood
AgriFarm	dataModel.Agrifood
AgriGreenhouse	dataModel.Agrifood
AgriParcelOperation	dataModel.Agrifood
AgriParcelRecord	dataModel.Agrifood
AgriParcel	dataModel.Agrifood
AgriPest	dataModel.Agrifood
AgriProductType	dataModel.Agrifood
AgriSoil	dataModel.Agrifood
Animal	dataModel.Agrifood
Compartment	dataModel.Agrifood
Pen	dataModel.Agrifood
Alert	dataModel.Alert
Anomaly	dataModel.Alert
BreedingOperation	dataModel.Aquaculture
FishContainment	dataModel.Aquaculture
BatteryStatus	dataModel.Battery
Battery	dataModel.Battery
StorageBatteryDevice	dataModel.Battery
StorageBatteryMeasurement	dataModel.Battery
BuildingOperation	dataModel.Building
BuildingType	dataModel.Building
Building	dataModel.Building
VibrationsObserved	dataModel.Building
CallUser	dataModel.CallComplaints
ComplaintsCollection	dataModel.CallComplaints
ComplaintsOrganization	dataModel.CallComplaints
Complaint	dataModel.CallComplaints
EUProofOfVaccination	dataModel.COVID19
VaccinationCertificate	dataModel.COVID19
AgentDCAT-AP	dataModel.DCAT-AP
CatalogueDCAT-AP	dataModel.DCAT-AP
CatalogueRecordDCAT-AP	dataModel.DCAT-AP
DataServiceDCAT-AP	dataModel.DCAT-AP
Dataset	dataModel.DCAT-AP
DistributionDCAT-AP	dataModel.DCAT-AP
Camera	dataModel.Device
DeviceMeasurement	dataModel.Device
DeviceModel	dataModel.Device
DeviceOperation	dataModel.Device
Device	dataModel.Device
PrivacyObject	dataModel.Device
SmartMeteringObservation	dataModel.Device
DigitalInnovationHubService	dataModel.DigitalInnovationHub
DigitalInnovationHub	dataModel.DigitalInnovationHub
DLTtxReceipt	dataModel.DistributedLedgerTech
ACMeasurement	dataModel.Energy
InverterDevice	dataModel.Energy
TechnicalCabinetDevice	dataModel.Energy
ThreePhaseAcMeasurement	dataModel.Energy
AccumulatorLimitSet	dataModel.EnergyCIM
AccumulatorLimit	dataModel.EnergyCIM
AccumulatorReset	dataModel.EnergyCIM
AccumulatorValue	dataModel.EnergyCIM
Accumulator	dataModel.EnergyCIM
ACDCConverterDCTerminal	dataModel.EnergyCIM
ACDCConverter	dataModel.EnergyCIM
ACDCTerminal	dataModel.EnergyCIM
ACLineSegment	dataModel.EnergyCIM
ActivePowerLimit	dataModel.EnergyCIM
ActivePowerPerCurrentFlow	dataModel.EnergyCIM
ActivePowerPerFrequency	dataModel.EnergyCIM
ActivePower	dataModel.EnergyCIM
AnalogControl	dataModel.EnergyCIM
AnalogLimitSet	dataModel.EnergyCIM
AnalogLimit	dataModel.EnergyCIM
AnalogValue	dataModel.EnergyCIM
Analog	dataModel.EnergyCIM
AngleDegrees	dataModel.EnergyCIM
AngleRadians	dataModel.EnergyCIM
ApparentPowerLimit	dataModel.EnergyCIM
ApparentPower	dataModel.EnergyCIM
Area	dataModel.EnergyCIM
AsynchronousMachineDynamics	dataModel.EnergyCIM
AsynchronousMachineEquivalentCircuit	dataModel.EnergyCIM
AsynchronousMachineTimeConstantReactance	dataModel.EnergyCIM
AsynchronousMachineUserDefined	dataModel.EnergyCIM
AsynchronousMachine	dataModel.EnergyCIM
BaseVoltage	dataModel.EnergyCIM
BasicIntervalSchedule	dataModel.EnergyCIM
Bay	dataModel.EnergyCIM
BusbarSection	dataModel.EnergyCIM
BusNameMarker	dataModel.EnergyCIM
CapacitancePerLength	dataModel.EnergyCIM
Capacitance	dataModel.EnergyCIM
Command	dataModel.EnergyCIM
Conductance	dataModel.EnergyCIM
ConductingEquipment	dataModel.EnergyCIM
Conductor	dataModel.EnergyCIM
ConformLoadGroup	dataModel.EnergyCIM
ConformLoadSchedule	dataModel.EnergyCIM
ConformLoad	dataModel.EnergyCIM
ConnectivityNodeContainer	dataModel.EnergyCIM
ConnectivityNode	dataModel.EnergyCIM
ControlAreaGeneratingUnit	dataModel.EnergyCIM
ControlArea	dataModel.EnergyCIM
Control	dataModel.EnergyCIM
CoordinateSystem	dataModel.EnergyCIM
CsConverter	dataModel.EnergyCIM
CurrentFlow	dataModel.EnergyCIM
CurrentLimit	dataModel.EnergyCIM
CurveData	dataModel.EnergyCIM
Curve	dataModel.EnergyCIM
DayType	dataModel.EnergyCIM
DCBaseTerminal	dataModel.EnergyCIM
DCConductingEquipment	dataModel.EnergyCIM
DCConverterUnit	dataModel.EnergyCIM
DCEquipmentContainer	dataModel.EnergyCIM
DCGround	dataModel.EnergyCIM
DCLineSegment	dataModel.EnergyCIM
DCLine	dataModel.EnergyCIM
DCNode	dataModel.EnergyCIM
DCSeriesDevice	dataModel.EnergyCIM
DCShunt	dataModel.EnergyCIM
DCTerminal	dataModel.EnergyCIM
DCTopologicalIsland	dataModel.EnergyCIM
DCTopologicalNode	dataModel.EnergyCIM
DiagramLayoutVersion	dataModel.EnergyCIM
DiagramObjectGluePoint	dataModel.EnergyCIM
DiagramObjectPoint	dataModel.EnergyCIM
DiagramObjectStyle	dataModel.EnergyCIM
DiagramObject	dataModel.EnergyCIM
DiagramStyle	dataModel.EnergyCIM
Diagram	dataModel.EnergyCIM
DiscExcContIEEEDEC1A	dataModel.EnergyCIM
DiscExcContIEEEDEC2A	dataModel.EnergyCIM
DiscExcContIEEEDEC3A	dataModel.EnergyCIM
DiscontinuousExcitationControlDynamics	dataModel.EnergyCIM
DiscontinuousExcitationControlUserDefined	dataModel.EnergyCIM
DiscreteValue	dataModel.EnergyCIM
Discrete	dataModel.EnergyCIM
DynamicsFunctionBlock	dataModel.EnergyCIM
DynamicsVersion	dataModel.EnergyCIM
EarthFaultCompensator	dataModel.EnergyCIM
EnergyArea	dataModel.EnergyCIM
EnergyConsumer	dataModel.EnergyCIM
EnergySchedulingType	dataModel.EnergyCIM
EnergySource	dataModel.EnergyCIM
EquipmentBoundaryVersion	dataModel.EnergyCIM
EquipmentContainer	dataModel.EnergyCIM
EquipmentVersion	dataModel.EnergyCIM
Equipment	dataModel.EnergyCIM
EquivalentBranch	dataModel.EnergyCIM
EquivalentEquipment	dataModel.EnergyCIM
EquivalentInjection	dataModel.EnergyCIM
EquivalentNetwork	dataModel.EnergyCIM
EquivalentShunt	dataModel.EnergyCIM
ExcAC1A	dataModel.EnergyCIM
ExcAC2A	dataModel.EnergyCIM
ExcAC3A	dataModel.EnergyCIM
ExcAC4A	dataModel.EnergyCIM
ExcAC5A	dataModel.EnergyCIM
ExcAC6A	dataModel.EnergyCIM
ExcAC8B	dataModel.EnergyCIM
ExcANS	dataModel.EnergyCIM
ExcAVR1	dataModel.EnergyCIM
ExcAVR2	dataModel.EnergyCIM
ExcAVR3	dataModel.EnergyCIM
ExcAVR4	dataModel.EnergyCIM
ExcAVR5	dataModel.EnergyCIM
ExcAVR7	dataModel.EnergyCIM
ExcBBC	dataModel.EnergyCIM
ExcCZ	dataModel.EnergyCIM
ExcDC1A	dataModel.EnergyCIM
ExcDC2A	dataModel.EnergyCIM
ExcDC3A1	dataModel.EnergyCIM
ExcDC3A	dataModel.EnergyCIM
ExcELIN1	dataModel.EnergyCIM
ExcELIN2	dataModel.EnergyCIM
ExcHU	dataModel.EnergyCIM
ExcIEEEAC1A	dataModel.EnergyCIM
ExcIEEEAC2A	dataModel.EnergyCIM
ExcIEEEAC3A	dataModel.EnergyCIM
ExcIEEEAC4A	dataModel.EnergyCIM
ExcIEEEAC5A	dataModel.EnergyCIM
ExcIEEEAC6A	dataModel.EnergyCIM
ExcIEEEAC7B	dataModel.EnergyCIM
ExcIEEEAC8B	dataModel.EnergyCIM
ExcIEEEDC1A	dataModel.EnergyCIM
ExcIEEEDC2A	dataModel.EnergyCIM
ExcIEEEDC3A	dataModel.EnergyCIM
ExcIEEEDC4B	dataModel.EnergyCIM
ExcIEEEST1A	dataModel.EnergyCIM
ExcIEEEST2A	dataModel.EnergyCIM
ExcIEEEST3A	dataModel.EnergyCIM
ExcIEEEST4B	dataModel.EnergyCIM
ExcIEEEST5B	dataModel.EnergyCIM
ExcIEEEST6B	dataModel.EnergyCIM
ExcIEEEST7B	dataModel.EnergyCIM
ExcitationSystemDynamics	dataModel.EnergyCIM
ExcitationSystemUserDefined	dataModel.EnergyCIM
ExcOEX3T	dataModel.EnergyCIM
ExcPIC	dataModel.EnergyCIM
ExcREXS	dataModel.EnergyCIM
ExcSCRX	dataModel.EnergyCIM
ExcSEXS	dataModel.EnergyCIM
ExcSK	dataModel.EnergyCIM
ExcST1A	dataModel.EnergyCIM
ExcST2A	dataModel.EnergyCIM
ExcST3A	dataModel.EnergyCIM
ExcST4B	dataModel.EnergyCIM
ExcST6B	dataModel.EnergyCIM
ExcST7B	dataModel.EnergyCIM
ExternalNetworkInjection	dataModel.EnergyCIM
FossilFuel	dataModel.EnergyCIM
Frequency	dataModel.EnergyCIM
GeneratingUnit	dataModel.EnergyCIM
GenICompensationForGenJ	dataModel.EnergyCIM
GeographicalLocationVersion	dataModel.EnergyCIM
GeographicalRegion	dataModel.EnergyCIM
GovCT1	dataModel.EnergyCIM
GovCT2	dataModel.EnergyCIM
GovGAST1	dataModel.EnergyCIM
GovGAST2	dataModel.EnergyCIM
GovGAST3	dataModel.EnergyCIM
GovGAST4	dataModel.EnergyCIM
GovGASTWD	dataModel.EnergyCIM
GovGAST	dataModel.EnergyCIM
GovHydro1	dataModel.EnergyCIM
GovHydro2	dataModel.EnergyCIM
GovHydro3	dataModel.EnergyCIM
GovHydro4	dataModel.EnergyCIM
GovHydroDD	dataModel.EnergyCIM
GovHydroFrancis	dataModel.EnergyCIM
GovHydroIEEE0	dataModel.EnergyCIM
GovHydroIEEE2	dataModel.EnergyCIM
GovHydroPelton	dataModel.EnergyCIM
GovHydroPID2	dataModel.EnergyCIM
GovHydroPID	dataModel.EnergyCIM
GovHydroR	dataModel.EnergyCIM
GovHydroWEH	dataModel.EnergyCIM
GovHydroWPID	dataModel.EnergyCIM
GovSteam0	dataModel.EnergyCIM
GovSteam1	dataModel.EnergyCIM
GovSteam2	dataModel.EnergyCIM
GovSteamCC	dataModel.EnergyCIM
GovSteamEU	dataModel.EnergyCIM
GovSteamFV2	dataModel.EnergyCIM
GovSteamFV3	dataModel.EnergyCIM
GovSteamFV4	dataModel.EnergyCIM
GovSteamIEEE1	dataModel.EnergyCIM
GovSteamSGO	dataModel.EnergyCIM
GrossToNetActivePowerCurve	dataModel.EnergyCIM
GroundingImpedance	dataModel.EnergyCIM
HydroGeneratingUnit	dataModel.EnergyCIM
HydroPowerPlant	dataModel.EnergyCIM
HydroPump	dataModel.EnergyCIM
IdentifiedObject	dataModel.EnergyCIM
InductancePerLength	dataModel.EnergyCIM
Inductance	dataModel.EnergyCIM
Length	dataModel.EnergyCIM
LimitSet	dataModel.EnergyCIM
LinearShuntCompensator	dataModel.EnergyCIM
Line	dataModel.EnergyCIM
LoadAggregate	dataModel.EnergyCIM
LoadArea	dataModel.EnergyCIM
LoadComposite	dataModel.EnergyCIM
LoadDynamics	dataModel.EnergyCIM
LoadGenericNonLinear	dataModel.EnergyCIM
LoadGroup	dataModel.EnergyCIM
LoadMotor	dataModel.EnergyCIM
LoadResponseCharacteristic	dataModel.EnergyCIM
LoadStatic	dataModel.EnergyCIM
LoadUserDefined	dataModel.EnergyCIM
Location	dataModel.EnergyCIM
MeasurementValueQuality	dataModel.EnergyCIM
MeasurementValueSource	dataModel.EnergyCIM
MeasurementValue	dataModel.EnergyCIM
Measurement	dataModel.EnergyCIM
MechanicalLoadDynamics	dataModel.EnergyCIM
MechanicalLoadUserDefined	dataModel.EnergyCIM
MechLoad1	dataModel.EnergyCIM
Money	dataModel.EnergyCIM
MutualCoupling	dataModel.EnergyCIM
NonConformLoadGroup	dataModel.EnergyCIM
NonConformLoadSchedule	dataModel.EnergyCIM
NonConformLoad	dataModel.EnergyCIM
NonlinearShuntCompensatorPoint	dataModel.EnergyCIM
NonlinearShuntCompensator	dataModel.EnergyCIM
OperationalLimitSet	dataModel.EnergyCIM
OperationalLimitType	dataModel.EnergyCIM
OperationalLimit	dataModel.EnergyCIM
OverexcitationLimiterDynamics	dataModel.EnergyCIM
OverexcitationLimiterUserDefined	dataModel.EnergyCIM
OverexcLim2	dataModel.EnergyCIM
OverexcLimIEEE	dataModel.EnergyCIM
OverexcLimX1	dataModel.EnergyCIM
OverexcLimX2	dataModel.EnergyCIM
PerCent	dataModel.EnergyCIM
PerLengthDCLineParameter	dataModel.EnergyCIM
PetersenCoil	dataModel.EnergyCIM
PFVArControllerType1Dynamics	dataModel.EnergyCIM
PFVArControllerType1UserDefined	dataModel.EnergyCIM
PFVArControllerType2Dynamics	dataModel.EnergyCIM
PFVArControllerType2UserDefined	dataModel.EnergyCIM
PFVArType1IEEEPFController	dataModel.EnergyCIM
PFVArType1IEEEVArController	dataModel.EnergyCIM
PFVArType2Common1	dataModel.EnergyCIM
PFVArType2IEEEPFController	dataModel.EnergyCIM
PFVArType2IEEEVArController	dataModel.EnergyCIM
PhaseTapChangerAsymmetrical	dataModel.EnergyCIM
PhaseTapChangerLinear	dataModel.EnergyCIM
PhaseTapChangerNonLinear	dataModel.EnergyCIM
PhaseTapChangerTablePoint	dataModel.EnergyCIM
PhaseTapChangerTable	dataModel.EnergyCIM
PhaseTapChangerTabular	dataModel.EnergyCIM
PhaseTapChanger	dataModel.EnergyCIM
PositionPoint	dataModel.EnergyCIM
PowerSystemResource	dataModel.EnergyCIM
PowerSystemStabilizerDynamics	dataModel.EnergyCIM
PowerSystemStabilizerUserDefined	dataModel.EnergyCIM
PowerTransformerEnd	dataModel.EnergyCIM
PowerTransformer	dataModel.EnergyCIM
ProprietaryParameterDynamics	dataModel.EnergyCIM
Pss1A	dataModel.EnergyCIM
Pss1	dataModel.EnergyCIM
Pss2B	dataModel.EnergyCIM
Pss2ST	dataModel.EnergyCIM
Pss5	dataModel.EnergyCIM
PssELIN2	dataModel.EnergyCIM
PssIEEE1A	dataModel.EnergyCIM
PssIEEE2B	dataModel.EnergyCIM
PssIEEE3B	dataModel.EnergyCIM
PssIEEE4B	dataModel.EnergyCIM
PssPTIST1	dataModel.EnergyCIM
PssPTIST3	dataModel.EnergyCIM
PssSB4	dataModel.EnergyCIM
PssSH	dataModel.EnergyCIM
PssSK	dataModel.EnergyCIM
PssWECC	dataModel.EnergyCIM
PU	dataModel.EnergyCIM
Quality61850	dataModel.EnergyCIM
RaiseLowerCommand	dataModel.EnergyCIM
RatioTapChangerTablePoint	dataModel.EnergyCIM
RatioTapChangerTable	dataModel.EnergyCIM
RatioTapChanger	dataModel.EnergyCIM
Reactance	dataModel.EnergyCIM
ReactiveCapabilityCurve	dataModel.EnergyCIM
ReactivePower	dataModel.EnergyCIM
RegularIntervalSchedule	dataModel.EnergyCIM
RegularTimePoint	dataModel.EnergyCIM
RegulatingCondEq	dataModel.EnergyCIM
RegulatingControl	dataModel.EnergyCIM
RegulationSchedule	dataModel.EnergyCIM
RemoteInputSignal	dataModel.EnergyCIM
ReportingGroup	dataModel.EnergyCIM
ResistancePerLength	dataModel.EnergyCIM
Resistance	dataModel.EnergyCIM
RotatingMachineDynamics	dataModel.EnergyCIM
RotatingMachine	dataModel.EnergyCIM
RotationSpeed	dataModel.EnergyCIM
SeasonDayTypeSchedule	dataModel.EnergyCIM
Season	dataModel.EnergyCIM
Seconds	dataModel.EnergyCIM
SeriesCompensator	dataModel.EnergyCIM
SetPoint	dataModel.EnergyCIM
ShuntCompensator	dataModel.EnergyCIM
Simple_Float	dataModel.EnergyCIM
StateVariablesVersion	dataModel.EnergyCIM
StaticVarCompensator	dataModel.EnergyCIM
SteadyStateHypothesisVersion	dataModel.EnergyCIM
StringMeasurementValue	dataModel.EnergyCIM
StringMeasurement	dataModel.EnergyCIM
SubGeographicalRegion	dataModel.EnergyCIM
SubLoadArea	dataModel.EnergyCIM
Substation	dataModel.EnergyCIM
Susceptance	dataModel.EnergyCIM
SvInjection	dataModel.EnergyCIM
SvPowerFlow	dataModel.EnergyCIM
SvShuntCompensatorSections	dataModel.EnergyCIM
SvStatus	dataModel.EnergyCIM
SvTapStep	dataModel.EnergyCIM
SvVoltage	dataModel.EnergyCIM
SwitchSchedule	dataModel.EnergyCIM
Switch	dataModel.EnergyCIM
SynchronousMachineDetailed	dataModel.EnergyCIM
SynchronousMachineDynamics	dataModel.EnergyCIM
SynchronousMachineEquivalentCircuit	dataModel.EnergyCIM
SynchronousMachineTimeConstantReactance	dataModel.EnergyCIM
SynchronousMachineUserDefined	dataModel.EnergyCIM
SynchronousMachine	dataModel.EnergyCIM
TapChangerControl	dataModel.EnergyCIM
TapChangerTablePoint	dataModel.EnergyCIM
TapChanger	dataModel.EnergyCIM
TapSchedule	dataModel.EnergyCIM
Temperature	dataModel.EnergyCIM
Terminal	dataModel.EnergyCIM
TextDiagramObject	dataModel.EnergyCIM
ThermalGeneratingUnit	dataModel.EnergyCIM
TieFlow	dataModel.EnergyCIM
TopologicalIsland	dataModel.EnergyCIM
TopologicalNode	dataModel.EnergyCIM
TopologyBoundaryVersion	dataModel.EnergyCIM
TopologyVersion	dataModel.EnergyCIM
TransformerEnd	dataModel.EnergyCIM
TurbineGovernorDynamics	dataModel.EnergyCIM
TurbineGovernorUserDefined	dataModel.EnergyCIM
TurbineLoadControllerDynamics	dataModel.EnergyCIM
TurbineLoadControllerUserDefined	dataModel.EnergyCIM
TurbLCFB1	dataModel.EnergyCIM
UnderexcitationLimiterDynamics	dataModel.EnergyCIM
UnderexcitationLimiterUserDefined	dataModel.EnergyCIM
UnderexcLim2Simplified	dataModel.EnergyCIM
UnderexcLimIEEE1	dataModel.EnergyCIM
UnderexcLimIEEE2	dataModel.EnergyCIM
UnderexcLimX1	dataModel.EnergyCIM
UnderexcLimX2	dataModel.EnergyCIM
VAdjIEEE	dataModel.EnergyCIM
ValueAliasSet	dataModel.EnergyCIM
ValueToAlias	dataModel.EnergyCIM
VCompIEEEType1	dataModel.EnergyCIM
VCompIEEEType2	dataModel.EnergyCIM
VisibilityLayer	dataModel.EnergyCIM
VoltageAdjusterDynamics	dataModel.EnergyCIM
VoltageAdjusterUserDefined	dataModel.EnergyCIM
VoltageCompensatorDynamics	dataModel.EnergyCIM
VoltageCompensatorUserDefined	dataModel.EnergyCIM
VoltageLevel	dataModel.EnergyCIM
VoltageLimit	dataModel.EnergyCIM
VoltagePerReactivePower	dataModel.EnergyCIM
Voltage	dataModel.EnergyCIM
VolumeFlowRate	dataModel.EnergyCIM
VsCapabilityCurve	dataModel.EnergyCIM
VsConverter	dataModel.EnergyCIM
WindAeroConstIEC	dataModel.EnergyCIM
WindAeroLinearIEC	dataModel.EnergyCIM
WindContCurrLimIEC	dataModel.EnergyCIM
WindContPitchAngleIEC	dataModel.EnergyCIM
WindContPType3IEC	dataModel.EnergyCIM
WindContPType4aIEC	dataModel.EnergyCIM
WindContPType4bIEC	dataModel.EnergyCIM
WindContQIEC	dataModel.EnergyCIM
WindContRotorRIEC	dataModel.EnergyCIM
WindDynamicsLookupTable	dataModel.EnergyCIM
WindGeneratingUnit	dataModel.EnergyCIM
WindGenTurbineType1IEC	dataModel.EnergyCIM
WindGenTurbineType2IEC	dataModel.EnergyCIM
WindGenTurbineType3aIEC	dataModel.EnergyCIM
WindGenTurbineType3bIEC	dataModel.EnergyCIM
WindGenTurbineType3IEC	dataModel.EnergyCIM
WindGenType4IEC	dataModel.EnergyCIM
WindMechIEC	dataModel.EnergyCIM
WindPitchContEmulIEC	dataModel.EnergyCIM
WindPlantDynamics	dataModel.EnergyCIM
WindPlantFreqPcontrolIEC	dataModel.EnergyCIM
WindPlantIEC	dataModel.EnergyCIM
WindPlantReactiveControlIEC	dataModel.EnergyCIM
WindPlantUserDefined	dataModel.EnergyCIM
WindProtectionIEC	dataModel.EnergyCIM
WindTurbineType1or2Dynamics	dataModel.EnergyCIM
WindTurbineType1or2IEC	dataModel.EnergyCIM
WindTurbineType3or4Dynamics	dataModel.EnergyCIM
WindTurbineType3or4IEC	dataModel.EnergyCIM
WindTurbineType4aIEC	dataModel.EnergyCIM
WindTurbineType4bIEC	dataModel.EnergyCIM
WindType1or2UserDefined	dataModel.EnergyCIM
WindType3or4UserDefined	dataModel.EnergyCIM
AeroAllergenObserved	dataModel.Environment
AirQualityMonitoring	dataModel.Environment
AirQualityObserved	dataModel.Environment
ElectroMagneticObserved	dataModel.Environment
EnvironmentObserved	dataModel.Environment
FloodMonitoring	dataModel.Environment
IndoorEnvironmentObserved	dataModel.Environment
NoiseLevelObserved	dataModel.Environment
PhreaticObserved	dataModel.Environment
RainFallRadarObservation	dataModel.Environment
WaterObserved	dataModel.Environment
FireForestStatus	dataModel.Forestry
CSVDialectFrictionlessData	dataModel.FrictionlessData
DataPackageFrictionlessData	dataModel.FrictionlessData
DataResourceFrictionlessData	dataModel.FrictionlessData
TableSchemaFrictionlessData	dataModel.FrictionlessData
free_bike_status	dataModel.GBFS
gbfs_versions	dataModel.GBFS
gbfs	dataModel.GBFS
geofencing_zones	dataModel.GBFS
station_information	dataModel.GBFS
station_status	dataModel.GBFS
system_alerts	dataModel.GBFS
system_calendar	dataModel.GBFS
system_hours	dataModel.GBFS
system_information	dataModel.GBFS
system_pricing_plans	dataModel.GBFS
system_regions	dataModel.GBFS
vehicle_types	dataModel.GBFS
GreenEnergyGenerator	dataModel.GreenEnergy
GreenEnergyMeasurement	dataModel.GreenEnergy
PhotovoltaicDevice	dataModel.GreenEnergy
PhotovoltaicMeasurement	dataModel.GreenEnergy
IssueReporting	dataModel.IssueTracking
Open311_ServiceRequest	dataModel.IssueTracking
Open311_ServiceType	dataModel.IssueTracking
keyPerformanceIndicator	dataModel.KeyPerformanceIndicator
MLModel	dataModel.MachineLearning
MLProcessing	dataModel.MachineLearning
SubscriptionQuery	dataModel.MachineLearning
ManufacturingMachineModel	dataModel.ManufacturingMachine
ManufacturingMachineOperation	dataModel.ManufacturingMachine
ManufacturingMachine	dataModel.ManufacturingMachine
MediaEvent	dataModel.Multimedia
acceleration	dataModel.OCF
AutoFocus	dataModel.OCF
AutomaticDocumentFeeder	dataModel.OCF
AutoWhiteBalance	dataModel.OCF
BatteryMaterial	dataModel.OCF
BinarySwitch	dataModel.OCF
BodyLocationTemperature	dataModel.OCF
Brewing	dataModel.OCF
Brightness	dataModel.OCF
Button	dataModel.OCF
Calorific	dataModel.OCF
Clock	dataModel.OCF
ColourChroma	dataModel.OCF
ColourCSC	dataModel.OCF
ColourHS	dataModel.OCF
consumable	dataModel.OCF
Conversion	dataModel.OCF
Count	dataModel.OCF
Dali	dataModel.OCF
Deodorization	dataModel.OCF
Door	dataModel.OCF
ecomode	dataModel.OCF
EnergyGeneration	dataModel.OCF
EnergyOverload	dataModel.OCF
GlassBreak	dataModel.OCF
GlucoseHealth	dataModel.OCF
GlucoseMeal	dataModel.OCF
GlucoseSampleLocation	dataModel.OCF
GlucoseTester	dataModel.OCF
heartRateZone	dataModel.OCF
HeatingZone	dataModel.OCF
ImpactSensor	dataModel.OCF
KeyCardSwitch	dataModel.OCF
KeyPadChar	dataModel.OCF
LockCode	dataModel.OCF
Lock	dataModel.OCF
magneticFieldDirection	dataModel.OCF
mediaSource	dataModel.OCF
Media	dataModel.OCF
Mode	dataModel.OCF
Motion	dataModel.OCF
movement	dataModel.OCF
MuscleOxygenSaturation	dataModel.OCF
NightMode	dataModel.OCF
PanTiltZoom	dataModel.OCF
Presence	dataModel.OCF
PrintQueue	dataModel.OCF
pulsatileoccurrence	dataModel.OCF
RemoteControl	dataModel.OCF
RenderingIndex	dataModel.OCF
Request	dataModel.OCF
Saturation	dataModel.OCF
SelectableLevels	dataModel.OCF
settings-accessibility	dataModel.OCF
settings-broadcasting	dataModel.OCF
settings-sound	dataModel.OCF
settings-support	dataModel.OCF
SignalStrength	dataModel.OCF
Sleep	dataModel.OCF
SoundPressureLevel	dataModel.OCF
SoundPressure	dataModel.OCF
Speech	dataModel.OCF
SpO2	dataModel.OCF
Touch	dataModel.OCF
UserInfo-retrieve	dataModel.OCF
UVARadiation	dataModel.OCF
UVBRadiation	dataModel.OCF
UVRadiation	dataModel.OCF
WaterInfo	dataModel.OCF
MotionDeviceSystem	dataModel.OPCUA
CrossSection	dataModel.OpenChannelManagement
OpenChannelCurve	dataModel.OpenChannelManagement
OpenChannelFlowRegulation	dataModel.OpenChannelManagement
OpenChannelJunction	dataModel.OpenChannelManagement
OpenChannelSystem	dataModel.OpenChannelManagement
OpenChannel	dataModel.OpenChannelManagement
RegulationStructureSimulation	dataModel.OpenChannelManagement
RegulationStructure	dataModel.OpenChannelManagement
SluiceGate	dataModel.OpenChannelManagement
Spillway	dataModel.OpenChannelManagement
OffStreetParking	dataModel.Parking
OnStreetParking	dataModel.Parking
ParkingAccess	dataModel.Parking
ParkingGroup	dataModel.Parking
ParkingSpot	dataModel.Parking
FlowerBed	dataModel.ParksAndGardens
Garden	dataModel.ParksAndGardens
GreenspaceRecord	dataModel.ParksAndGardens
SmartPointOfInteraction	dataModel.PointOfInteraction
SmartSpot	dataModel.PointOfInteraction
Beach	dataModel.PointOfInterest
Museum	dataModel.PointOfInterest
PointOfInterest	dataModel.PointOfInterest
Store	dataModel.PointOfInterest
BoatAuthorized	dataModel.Ports
BoatPlacesAvailable	dataModel.Ports
BoatPlacesPricing	dataModel.Ports
SeaportFacilities	dataModel.Ports
RevenueCollection	dataModel.PublicAccountability
QueueMonitor	dataModel.QueueManagement
Asset	dataModel.RiskManagement
CyberAnalysis	dataModel.RiskManagement
Exposure	dataModel.RiskManagement
GISData	dataModel.RiskManagement
Hazard	dataModel.RiskManagement
Measure	dataModel.RiskManagement
Mitigation	dataModel.RiskManagement
NetworkServiceAlert	dataModel.RiskManagement
Risk	dataModel.RiskManagement
Vulnerability	dataModel.RiskManagement
Pallet	dataModel.RoboticIndustrialActivities
Piece	dataModel.RoboticIndustrialActivities
RobotArm	dataModel.RoboticIndustrialActivities
RoboticCell	dataModel.RoboticIndustrialActivities
VacuumPump	dataModel.RoboticIndustrialActivities
EOAnalysis	dataModel.SatelliteImagery
EODataHub	dataModel.SatelliteImagery
EOGeoDataLayer	dataModel.SatelliteImagery
EOInstrument	dataModel.SatelliteImagery
EOProduct	dataModel.SatelliteImagery
EOSatellitePlatform	dataModel.SatelliteImagery
SMAnalysis	dataModel.SocialMedia
SMCollection	dataModel.SocialMedia
SMPost	dataModel.SocialMedia
SMRefLocation	dataModel.SocialMedia
SMUser	dataModel.SocialMedia
StreetlightControlCabinet	dataModel.Streetlighting
StreetlightFeeder	dataModel.Streetlighting
StreetlightGroup	dataModel.Streetlighting
StreetlightModel	dataModel.Streetlighting
Streetlight	dataModel.Streetlighting
Event	dataModel.TourismDestinations
TouristDestination	dataModel.TourismDestinations
TouristTrip	dataModel.TourismDestinations
BikeHireDockingStation	dataModel.Transportation
BikeLane	dataModel.Transportation
CityWork	dataModel.Transportation
CrowdFlowObserved	dataModel.Transportation
EVChargingStation	dataModel.Transportation
FareCollectionSystem	dataModel.Transportation
FleetVehicleOperation	dataModel.Transportation
FleetVehicleStatus	dataModel.Transportation
FleetVehicle	dataModel.Transportation
ItemFlowObserved	dataModel.Transportation
RestrictedTrafficArea	dataModel.Transportation
RestrictionException	dataModel.Transportation
RoadAccident	dataModel.Transportation
RoadSegment	dataModel.Transportation
Road	dataModel.Transportation
SpecialRestriction	dataModel.Transportation
TrafficFlowObserved	dataModel.Transportation
TrafficViolation	dataModel.Transportation
TransportStation	dataModel.Transportation
VehicleFault	dataModel.Transportation
VehicleModel	dataModel.Transportation
Vehicle	dataModel.Transportation
UnmannedAerialVehicleADSB	dataModel.UnmannedAerialVehicle
UnmannedAerialVehicleEvent	dataModel.UnmannedAerialVehicle
UnmannedAerialVehicleModel	dataModel.UnmannedAerialVehicle
UnmannedAerialVehicleTMSFlightMessageAgent	dataModel.UnmannedAerialVehicle
UnmannedAerialVehicleTMSFlightMessage	dataModel.UnmannedAerialVehicle
UnmannedAerialVehicleTMS	dataModel.UnmannedAerialVehicle
UnmannedAerialVehicle	dataModel.UnmannedAerialVehicle
ArrivalEstimation	dataModel.UrbanMobility
GtfsAccessPoint	dataModel.UrbanMobility
GtfsAgency	dataModel.UrbanMobility
GtfsCalendarDateRule	dataModel.UrbanMobility
GtfsCalendarRule	dataModel.UrbanMobility
GtfsFrequency	dataModel.UrbanMobility
GtfsRoute	dataModel.UrbanMobility
GtfsService	dataModel.UrbanMobility
GtfsShape	dataModel.UrbanMobility
GtfsStation	dataModel.UrbanMobility
GtfsStopTime	dataModel.UrbanMobility
GtfsStop	dataModel.UrbanMobility
GtfsTransferRule	dataModel.UrbanMobility
GtfsTrip	dataModel.UrbanMobility
PublicTransportRoute	dataModel.UrbanMobility
PublicTransportStop	dataModel.UrbanMobility
Activity	dataModel.User
UserContext	dataModel.User
WasteContainerIsle	dataModel.WasteManagement
WasteContainerModel	dataModel.WasteManagement
WasteContainer	dataModel.WasteManagement
Blower	dataModel.WasteWater
OffGasStack	dataModel.WasteWater
WasteWaterJunction	dataModel.WasteWater
WasteWaterPlant	dataModel.WasteWater
WasteWaterSimulationResult	dataModel.WasteWater
WasteWaterTank	dataModel.WasteWater
WaterConsumptionObserved	dataModel.WaterConsumption
Junction	dataModel.WaterDistributionManagementEPANET
Network	dataModel.WaterDistributionManagementEPANET
Pattern	dataModel.WaterDistributionManagementEPANET
Pipe	dataModel.WaterDistributionManagementEPANET
Pump	dataModel.WaterDistributionManagementEPANET
Reservoir	dataModel.WaterDistributionManagementEPANET
SimulationResult	dataModel.WaterDistributionManagementEPANET
SimulationScenario	dataModel.WaterDistributionManagementEPANET
Tank	dataModel.WaterDistributionManagementEPANET
Valve	dataModel.WaterDistributionManagementEPANET
WaterQualityObserved	dataModel.WaterQuality
SeaConditions	dataModel.Weather
WeatherAlert	dataModel.Weather
WeatherForecast	dataModel.Weather
WeatherObserved	dataModel.Weather
AccessPoint	dataModel.WifiNetwork
WifiPointOfInterest	dataModel.WifiNetwork
